0, 0, 0, 0, 1, 1, 1, 1, -1, 2, 
-1, -1, -1, -1, -1, -1, -1, -1, -1, 2, 
-1, -1, -1, 17, -1, -1, -1, -1, -1, 2, 
-1, -1, -1, 17, -1, -1, -1, -1, -1, -1, 
-1, -1, -1, 17, -1, -1, -1, -1, -1, -1, 
-1, -1, -1, 17, -1, -1, -1, -1, -1, -1, 
-1, -1, -1, -1, -1, -1, -1, -1, -1, -1, 
-1, -1, -1, -1, -1, -1, -1, -1, -1, -1, 
-1, -1, -1, -1, 21, 21, 21, -1, -1, -1, 
-1, -1, -1, -1, -1, -1, -1, -1, -1, -1, 
